[
  {
    "type": "mapgen",
    "om_terrain": [ "cabin" ],
    "weight": 200,
    "object": {
      "fill_ter": "t_floor",
      "rows": [
        "------------------------",
        "-**********************-",
        "-...#######...*********-",
        "-...#]]z [#........****-",
        "-...#    [#...###....**-",
        "-...#L    #...#L#.***.*-",
        "-...###X###...#=#..****-",
        "-......~~~....~~~~..***-",
        "-........~~~~~~.......*-",
        "-..######+##ww#######.*-",
        "-..# RRR   Y  A#c  u#.*-",
        "-..# RSR      A#d  u#..-",
        "-..# rrr      A#   R#..-",
        "-..#          A##+###..-",
        "-..wdc              #..-",
        "-..wd               w..-",
        "-..#dOOO  cttc      w..-",
        "-..#####  cttc     3#.*-",
        "-..w   =           u#.*-",
        "-..wBBD#        152u#%*-",
        "-..#####ww##+###ww###.*-",
        "-********..~~P.......**-",
        "-********..~~..********-",
        "-----------GG-----------"
      ],
      "palettes": [ "cabin_palette" ],
      "terrain": { "[": "t_floor", "]": "t_floor", "X": "t_door_boarded" },
      "furniture": { "[": "f_bookcase", "]": "f_counter" },
      "items": {
        "[": { "item": "sanguine_cult_books_postapoc", "chance": 50, "repeat": 3 },
        "z": { "item": "cult_sacrifice", "chance": 100 }
      },
      "place_loot": [
        { "item": "book_magicfordummies", "x": [ 5, 6 ], "y": 3 },
        { "item": "note_sanguine_hint", "x": [ 5, 6 ], "y": 3 },
        { "item": "arcanemap", "x": [ 5, 6 ], "y": 3 }
      ],
      "place_monsters": [ { "monster": "GROUP_ZOMBIE", "x": 7, "y": 4 } ]
    }
  },
  {
    "type": "mapgen",
    "om_terrain": [ "cabin_1" ],
    "weight": 200,
    "object": {
      "fill_ter": "t_floor",
      "rows": [
        "........................",
        "........................",
        "...%....................",
        "..######w##++#########..",
        "..#R  d#sT#  #A DBBD #..",
        "..#R  c#  #  #A  BB  w..",
        "..wR   #  =  =       w..",
        "..wR   #~~#  #########..",
        "..#R   ####  X  [[[dc#..",
        "..#R   L##A  #     d #..",
        "..####=####  #6]]    #..",
        "..#ttb  uu#  #########..",
        "..wttb   u#  #a OOO  w..",
        "..wbb     =  =    rrrw..",
        "..#      u#  #    rSr#..",
        "..#1F5V234#  #a   rrr#..",
        "..###ww####++####ww###..",
        "..o bbbb             o..",
        "..-                  -..",
        "..-                  -..",
        "..o-------oGGo-------o..",
        "........................",
        "........................",
        "........................"
      ],
      "palettes": [ "cabin_palette" ],
      "terrain": { "[": "t_floor", "]": "t_floor", "6": "t_floor", "X": "t_door_boarded" },
      "furniture": { "[": "f_bookcase", "]": "f_counter", "6": "f_statue" },
      "place_rubble": [
        { "x": 20, "y": 17, "items": true },
        { "x": 19, "y": 18, "items": true },
        { "x": 20, "y": 18, "items": true },
        { "x": 18, "y": 19, "items": true },
        { "x": 19, "y": 19, "items": true },
        { "x": 20, "y": 19, "items": true },
        { "x": 19, "y": 3, "items": true },
        { "x": 20, "y": 3, "items": true },
        { "x": 21, "y": 3, "items": true },
        { "x": 20, "y": 4, "items": true },
        { "x": 21, "y": 4, "items": true },
        { "x": 21, "y": 5, "items": true }
      ],
      "items": { "[": { "item": "cleansing_flame_books_postapoc", "chance": 50, "repeat": 3 } },
      "place_loot": [
        { "group": "homeguns", "x": 7, "y": 9, "chance": 30, "ammo": 90, "magazine": 100 },
        { "item": "note_flame_hint", "x": 15, "y": 10 },
        { "item": "holy_symbol", "x": 15, "y": 10, "chance": 75 },
        { "item": "spirit_talisman", "x": 15, "y": 10, "chance": 75 },
        { "item": "book_magicfordummies", "x": 16, "y": 10 },
        { "item": "arcanemap", "x": 16, "y": 10 }
      ],
      "place_monsters": [ { "monster": "GROUP_ZOMBIE", "x": 11, "y": 12 } ]
    }
  },
  {
    "type": "mapgen",
    "om_terrain": [ "cabin_2" ],
    "weight": 125,
    "object": {
      "fill_ter": "t_floor",
      "rows": [
        ".*********.~~.*********.",
        ".*********.~~.*********.",
        ".*********.~~.*********.",
        "..........~~~~~~~~~~~~~~",
        ".o-------o    o-------o~",
        ".-                    -~",
        ".-   at          cttc -~",
        ".##w###w###++###w###w##~",
        ".#L CCC L#Y     lttl 4#~",
        ".#       +    o  tt  5w~",
        ".#RRRLRRR#    A  l   Vw~",
        ".#########    A      F#~",
        ".#rrr a       A      u#~",
        ".wrSr d       o   o123w~",
        ".wrrr                 w~",
        ".#OOO    AcccA        #~",
        ".#####=########X###=###~",
        ".#D    AAdd#cd   [#  T#~",
        ".#BB     cd#     [#s  +~",
        ".#BB      A#z  ] [# hh#.",
        ".###ww#ww##############.",
        ".********************%..",
        "************************",
        "************************"
      ],
      "palettes": [ "cabin_palette" ],
      "terrain": { "[": "t_floor", "]": "t_floor", "X": "t_door_boarded" },
      "furniture": { "[": "f_bookcase", "]": "f_counter" },
      "items": {
        "[": { "item": "sanguine_cult_books_postapoc", "chance": 50, "repeat": 3 },
        "z": { "item": "cult_sacrifice", "chance": 100 }
      },
      "place_loot": [
        { "group": "harddrugs", "x": [ 19, 21 ], "y": [ 17, 19 ], "chance": 40 },
        { "group": "guns_rifle_common", "x": 9, "y": 15, "chance": 50, "ammo": 50, "magazine": 100 },
        { "item": "book_magicfordummies", "x": 15, "y": 19 },
        { "item": "note_sanguine_hint", "x": 15, "y": 19 },
        { "item": "arcanemap", "x": 15, "y": 19 }
      ],
      "place_monsters": [ { "monster": "GROUP_ZOMBIE", "x": [ 2, 21 ], "y": [ 2, 21 ] } ]
    }
  },
  {
    "om_terrain": "cabin_3",
    "type": "mapgen",
    "weight": 150,
    "object": {
      "fill_ter": "t_floor",
      "rows": [
        "************************",
        "************************",
        "*********.............**",
        "********...............*",
        "********...............*",
        "********..##ww#+#####..*",
        "********..#14&  #[dc#..*",
        "********..wF    #[  #..*",
        "********..w2   t#[ ]#..*",
        "********..#S   c#X###..*",
        "********..#35       #..*",
        "********..####      w..*",
        "********.0#s +  B BBw..*",
        "********.%#T #Y BDBB#..*",
        "********..#####+#ww##..*",
        "********...bbb.~.......*",
        "********...~~~~~.......*",
        "*********......~......**",
        "**************.~.*******",
        "*************..~.*******",
        "*************.~~.*******",
        "*************.~..*******",
        "*************.~.********",
        "*************.~.********"
      ],
      "palettes": [ "cabin_palette" ],
      "terrain": { "[": "t_floor", "]": "t_floor", "X": "t_door_boarded" },
      "furniture": { "[": "f_bookcase", "]": "f_counter" },
      "items": { "[": { "item": "chalice_cult_books_postapoc", "chance": 50, "repeat": 3 } },
      "place_loot": [
        { "item": "book_magicfordummies", "x": 19, "y": 8 },
        { "item": "note_chalice_hint", "x": 19, "y": 8 },
        { "item": "arcanemap", "x": 19, "y": 8 }
      ],
      "place_monster": [ { "monster": "mon_feral_magehunter", "x": 15, "y": 10, "chance": 15 } ],
      "place_nested": [ { "chunks": [ [ "null", 2 ], [ "cabin_cellar_stairs", 1 ] ], "x": 12, "y": 7 } ]
    }
  },
  {
    "om_terrain": "cabin_4",
    "type": "mapgen",
    "weight": 150,
    "object": {
      "fill_ter": "t_floor",
      "rows": [
        "********.~.*************",
        "********.~.*************",
        "********.~.*************",
        "***......~........******",
        "**.......~.........*****",
        "**.###ww#+#w######.*****",
        "**.#F&C   Y  # ]6#.*****",
        "**.w5 Cl     X   #.*****",
        "**.wS Cl ctc #d [#.*****",
        "**.#1 Cl ctc #c [#.*****",
        "**.#2        #####.*****",
        "**.w3    RRR +~~...*****",
        "**.#4R y ### #.~~~....**",
        "**.###+#     #z...~~~...",
        "**.#   #BB BB#.......~~~",
        "**0#T&s#BBDBB#....**....",
        "**.######w#w##...*******",
        "**..%............*******",
        "************************",
        "************************",
        "************************",
        "************************",
        "************************",
        "************************"
      ],
      "palettes": [ "cabin_palette" ],
      "terrain": { "[": "t_floor", "]": "t_floor", "6": "t_floor", "X": "t_door_boarded" },
      "furniture": { "[": "f_bookcase", "]": "f_counter", "6": "f_statue" },
      "items": { "[": { "item": "cleansing_flame_books_postapoc", "chance": 60, "repeat": 3 } },
      "place_loot": [
        { "item": "holy_symbol", "x": 15, "y": 6, "chance": 75 },
        { "item": "spirit_talisman", "x": 15, "y": 6, "chance": 75 },
        { "item": "book_magicfordummies", "x": 15, "y": 6 },
        { "item": "note_flame_hint", "x": 15, "y": 6 },
        { "item": "arcanemap", "x": 15, "y": 6 }
      ],
      "place_monster": [ { "monster": "mon_feral_swamp_witch", "x": 6, "y": 11, "chance": 30 } ],
      "place_nested": [ { "chunks": [ [ "null", 2 ], [ "cabin_cellar_stairs", 1 ] ], "x": 3, "y": 9 } ]
    }
  },
  {
    "om_terrain": "cabin_5",
    "type": "mapgen",
    "weight": 150,
    "object": {
      "fill_ter": "t_floor",
      "rows": [
        "**********.~.***********",
        "**********.~.***********",
        "*******....~.....*******",
        "*****......~.......*****",
        "****.......~........****",
        "****.##w###+##ww###.****",
        "****.#BBD#Y    c  #.****",
        "****.wBB #     ttcw.****",
        "****.#   # O  ctt #.****",
        "****.##X## O    c #.****",
        "****.#] [# O  CCC1#.****",
        "****.#  [#       2w.****",
        "****.#cd[#A  &sSF3#.****",
        "****.##w###+##ww###.****",
        "****..%....~........****",
        "*****......~.......*****",
        "**********.~.***********",
        "**.....**.~~.***********",
        "**.###...~~..***********",
        "**.#T+~~~~..************",
        "**.###.....*************",
        "**.....*****************",
        "************************",
        "************************"
      ],
      "palettes": [ "cabin_palette" ],
      "terrain": { "[": "t_floor", "]": "t_floor", "X": "t_door_boarded" },
      "furniture": { "[": "f_bookcase", "]": "f_counter" },
      "items": {
        "[": { "item": "sanguine_cult_books_postapoc", "chance": 60, "repeat": 3 },
        "z": { "item": "cult_sacrifice", "chance": 100 }
      },
      "place_loot": [
        { "item": "book_magicfordummies", "x": 6, "y": 10 },
        { "item": "note_sanguine_hint", "x": 6, "y": 10 },
        { "item": "arcanemap", "x": 6, "y": 10 }
      ],
      "place_monster": [ { "monster": "mon_feral_sanguinist", "x": 12, "y": 9, "chance": 30 } ],
      "place_nested": [ { "chunks": [ [ "null", 2 ], [ "cabin_cellar_stairs", 1 ] ], "x": 6, "y": 6 } ]
    }
  },
  {
    "om_terrain": "cabin_6",
    "type": "mapgen",
    "weight": 150,
    "object": {
      "fill_ter": "t_floor",
      "rows": [
        "***********.~.**********",
        "***********.~.**********",
        "**********..~..*********",
        "********....~....*******",
        "********.#w#+#w#.*******",
        "********.wb   cw.*******",
        "*****....#b  ct#....****",
        "*****.##w###=###w##.****",
        "***...#15SFR &# BB#.****",
        "***...w2     R# BBw.****",
        "**....w3 CC   +  D#.****",
        "......#y ll   ##+##%****",
        "~~~~~~+       #] [#.****",
        "......#cttc#+##  [#.****",
        "***...#cttc# T#cd[#.****",
        "*****.##ww#########.****",
        "*****...............****",
        "************************",
        "************************",
        "************************",
        "************************",
        "************************",
        "************************",
        "************************"
      ],
      "palettes": [ "cabin_palette" ],
      "terrain": { "[": "t_floor", "]": "t_floor", "_": [ "t_dirt", [ "t_grass", 6 ] ], "X": "t_door_boarded" },
      "furniture": { "[": "f_bookcase", "]": "f_counter" },
      "items": { "[": { "item": "chalice_cult_books_postapoc", "chance": 50, "repeat": 3 } },
      "place_loot": [
        { "item": "book_magicfordummies", "x": 15, "y": 12 },
        { "item": "note_chalice_hint", "x": 15, "y": 12 },
        { "item": "arcanemap", "x": 15, "y": 12 }
      ],
      "place_nested": [ { "chunks": [ [ "null", 2 ], [ "cabin_cellar_stairs", 1 ] ], "x": 5, "y": 8 } ]
    }
  },
  {
    "om_terrain": "cabin_7",
    "type": "mapgen",
    "weight": 150,
    "object": {
      "fill_ter": "t_floor",
      "place_vehicles": [ { "chance": 60, "fuel": 30, "rotation": 90, "status": -1, "vehicle": "forgotten_vehicles", "x": 8, "y": 7 } ],
      "rows": [
        "**********..............",
        "******..................",
        "*****........###ww#####.",
        "*****........#F1s23#sT#.",
        "*****........wS    +  #.",
        "*****........#C   #####.",
        "*****..~~~~~~+    #DBBw.",
        "*****.~~~~~~~#    +   #.",
        "*****.~~.....#cc  #DBBw.",
        "*****.~~.....wttc #####.",
        "****..~~.....wttc X  c#.",
        "***.qq>>q....#OOO #  d#%",
        "**.qQQ>>Qq...#    #[  #.",
        "**.qQQ>>Qqq..#AZA #[6]#.",
        "**qQQQ>>QQqq.####+#####.",
        "*.qQQQQQQQQq...~~~~~....",
        "*qQQQQQQQQQQqqq~...~....",
        "*qQQQQQQQQQQQqq>qq.~bb..",
        "*qqQQQQQQQQQQQQ>Qqq~....",
        "*.qQQQQQQQQQQQG>QQq~....",
        "*.qqQQQQQQQQQQGQQQq~bb..",
        "*.qqqQQQQQQQQQQQQQq....*",
        "**..qqQQqqqQQQQQqq.*****",
        "******qq***qqqqq********"
      ],
      "palettes": [ "cabin_palette" ],
      "terrain": { "[": "t_floor", "]": "t_floor", "6": "t_floor", "X": "t_door_boarded" },
      "furniture": { "[": "f_bookcase", "]": "f_counter", "6": "f_statue" },
      "items": { "[": { "item": "cleansing_flame_books_postapoc", "chance": 60, "repeat": 3 } },
      "place_loot": [
        { "item": "holy_symbol", "x": 21, "y": 13, "chance": 75 },
        { "item": "spirit_talisman", "x": 21, "y": 13, "chance": 75 },
        { "item": "book_magicfordummies", "x": 21, "y": 13 },
        { "item": "note_flame_hint", "x": 21, "y": 13 },
        { "item": "arcanemap", "x": 21, "y": 13 }
      ]
    }
  }
]
